Afghanistan - Kabul
Armenia - Yerevan
Azerbaijan - Baku
Bahrain - Manama
Bangladesh - Dhaka
Bhutan - Thimphu
Brunei - Bandar Seri Begawan
Cambodia - Phnom Penh
China - Beijing
Taiwan - Taipei
East Timor - Dili
India - New Delhi
Indonesia - Jakarta
Iran - Tehran
Iraq - Baghdad
Israel - Jerusalem
Palestine - Gaza
Japan - Tokyo
Jordan - Amman
Kazakhstan - Astana
Kuwait - Kuwait
Kyrgyzstan - Bishkek
Laos - Vientiane
Lebanon - Beirut
Malaysia - Kuala Lumpur
Maldives - Male
Mongolia - Ulaanbaatar
Myanmar - Naypyidaw
Nepal - Kathmandu
North Korea - Pyongyang
Oman - Muscat
Pakistan - Islamabad
Philippines - Manila
Qatar - Doha
Russia - Moscow
Saudi Arabia - Riyadh
Singapore - Singapore
South Korea - Seoul
Sri Lanka - Sri Jayawardenapura Kotte
Syria - Damascus
Tajikistan - Dushanbe
Thailand - Bangkok
Turkey - Ankara
Turkmenistan - Asgabat
United Arab Emirates - Abu Dhabi
Uzbekistan - Tashkent
Vietnam - Hanoi
Yemen - Sana'a